MAZE 10 10
  0   7   0   8
  9   4   9   5
  5   0   5   1
  4   6   4   7
  8   6   8   7
  6   7   7   7
  7   6   7   7
  5   6   6   6
  9   0   9   1
  4   0   4   1
  7   5   8   5
  6   0   7   0
  4   7   4   8
  1   7   1   8
  7   3   8   3
  5   8   6   8
  6   2   6   3
  6   8   6   9
  4   4   4   5
  1   6   2   6
  7   2   7   3
  7   4   7   5
  6   5   6   6
  1   3   1   4
  3   5   3   6
  0   2   1   2
  2   3   3   3
  5   2   5   3
  2   5   3   5
  9   8   9   9
  6   4   7   4
  3   3   4   3
  4   3   4   4
  2   6   2   7
  2   8   2   9
  2   4   3   4
  1   6   1   7
  2   6   3   6
  3   4   3   5
  4   1   5   1
  0   6   1   6
  7   8   8   8
  8   5   8   6
  4   5   5   5
  6   9   7   9
  1   2   1   3
  4   2   4   3
  0   4   1   4
  6   1   6   2
  1   9   2   9
  8   2   8   3
  1   0   2   0
  7   0   7   1
  2   2   2   3
  5   3   6   3
  3   4   4   4
  2   1   2   2
  3   2   4   2
  7   3   7   4
  3   7   3   8
  4   8   4   9
  0   8   0   9
  0   3   1   3
  7   9   8   9
  3   9   4   9
  3   0   3   1
  8   3   8   4
  1   4   2   4
  9   1   9   2
  4   6   5   6
  0   3   0   4
  6   4   6   5
  2   7   2   8
  2   2   3   2
  6   8   7   8
  6   6   6   7
  6   2   7   2
  8   7   8   8
  7   2   8   2
  0   0   0   1
  2   0   2   1
